£Ü£Ü£Ü£Ü£Ü£Ü£Ü£Ü£Ü£Ü£Ü£Ü£Ü£Ü£Ü
£Ü¡¡¡¡£Ü£Ü¡¡¡¡£Ü¡¡¡¡£Ü¡¡¡¡£Ü£Ü
£Ü£Ü¡¡£Ü¡¡¡¡¡¡¡¡¡¡£Ü¡¡¡¡¡¡¡¡£Ü
£Ü£¡¡¡¡¡¡¡¡¡¡¡¡¡¡¡£Ü£Ü¡¡£Ü£Ü£Ü
£Ü¡¡¡¡£Ü¡¡¡¡£Ü¡¡¡¡£Ü¡¡£Ü£Ü£Ü£Ü
£Ü£Ü¡¡¡¡£ª£Ü¡¡¡¡£Ü£Ü¡¡£Ü£Ü¡¡£Ü
£Ü£Ü¡¡¡¡£Ü£Ü£Ü¡¡¡¡¡¡¡¡£Ü£Ü¡¡£Ü
£Ü£Ü£Ü¡¡£Ü£Ü¡¡£Ü£¡¡¡¡¡¡¡£¡£Ü£Ü
£Ü¡¡£Ü¡¡£Ü£Ü£Ü£Ü£Ü¡¡¡¡¡¡£Ü¡¡£Ü
£Ü¡¡£ª¡¡¡¡¡¡¡¡£ª¡¡¡¡¡¡£Ü¡¡£Ü£Ü
£Ü¡¡¡¡¡¡£Ü£Ü¡¡£Ü¡¡¡¡£Ü£ª£À£Ü£Ü
£Ü¡¡£Ü£Ü£Ü¡¡£¡¡¡£Ü¡¡¡¡¡¡¡¡¡¡£Ü
£Ü¡¡¡¡¡¡£Ü£Ü¡¡£¡¡¡£Ü¡¡¡¡¡¡¡¡£Ü
£Ü¡¡¡¡¡¡¡¡¡¡£Ü¡¡£Ü£Ü£Ü¡¡£Ü£ª£Ü
£Ü£Ü£Ü£Ü£Ü£Ü£Ü£Ü£Ü£Ü£Ü£Ü£Ü£Ü£Ü
