£Ü£Ü£Ü£Ü£Ü£Ü£Ü£Ü£Ü£Ü£Ü£Ü£Ü£Ü£Ü
£Ü£¡£Ü¡¡£ª£Ü£Ü¡¡¡¡£Ü¡¡¡¡¡¡£Ü£Ü
£Ü¡¡¡¡¡¡£À¡¡¡¡£ª£Ü£Ü¡¡¡¡£Ü¡¡£Ü
£Ü¡¡£Ü¡¡¡¡£Ü£Ü£Ü£Ü£¡£Ü¡¡£Ü¡¡£Ü
£Ü£Ü¡¡£ª¡¡¡¡£Ü¡¡£Ü¡¡£Ü£Ü£Ü¡¡£Ü
£Ü¡¡¡¡£Ü£Ü¡¡£Ü¡¡¡¡¡¡¡¡£Ü£Ü¡¡£Ü
£Ü¡¡£Ü¡¡£¡¡¡¡¡¡¡¡¡¡¡¡¡£¡¡¡¡¡£Ü
£Ü£Ü¡¡¡¡£Ü¡¡¡¡¡¡£Ü¡¡¡¡¡¡£Ü£Ü£Ü
£Ü¡¡£ª¡¡£Ü¡¡¡¡¡¡¡¡¡¡£Ü¡¡¡¡¡¡£Ü
£Ü¡¡¡¡¡¡¡¡£Ü¡¡¡¡£Ü£Ü¡¡£Ü£Ü¡¡£Ü
£Ü£Ü£Ü¡¡£Ü£Ü£¡¡¡¡¡£Ü£Ü¡¡£ª¡¡£Ü
£Ü¡¡¡¡£Ü¡¡¡¡£Ü¡¡¡¡¡¡¡¡¡¡¡¡£Ü£Ü
£Ü¡¡£Ü£Ü¡¡£Ü¡¡£Ü£¡¡¡£Ü£Ü¡¡£Ü£Ü
£Ü¡¡¡¡£Ü£Ü£Ü¡¡£Ü£Ü¡¡¡¡£Ü¡¡¡¡£Ü
£Ü£Ü£Ü£Ü£Ü£Ü£Ü£Ü£Ü£Ü£Ü£Ü£Ü£Ü£Ü
