£Ü£Ü£Ü£Ü£Ü£Ü£Ü£Ü£Ü£Ü£Ü£Ü£Ü£Ü£Ü
£Ü£Ü£Ü¡¡£Ü£Ü¡¡£Ü¡¡£Ü£Ü¡¡¡¡£Ü£Ü
£Ü£Ü£Ü¡¡£¡£Ü£Ü¡¡£Ü¡¡¡¡¡¡¡¡¡¡£Ü
£Ü¡¡¡¡¡¡£Ü£Ü¡¡£Ü¡¡¡¡¡¡£Ü¡¡£Ü£Ü
£Ü£Ü¡¡£Ü¡¡£Ü¡¡£ª¡¡£Ü¡¡¡¡£ª£Ü£Ü
£Ü£Ü£Ü£Ü¡¡¡¡¡¡¡¡£Ü£Ü¡¡£Ü¡¡£Ü£Ü
£Ü£Ü£Ü£Ü£ª£Ü£Ü£À¡¡£Ü£Ü¡¡¡¡¡¡£Ü
£Ü¡¡¡¡¡¡£Ü¡¡£Ü¡¡£Ü£Ü¡¡¡¡¡¡¡¡£Ü
£Ü£Ü¡¡¡¡¡¡¡¡¡¡¡¡¡¡¡¡¡¡¡¡£Ü£Ü£Ü
£Ü¡¡£Ü¡¡£ª¡¡£Ü£¡£Ü¡¡¡¡£¡¡¡£Ü£Ü
£Ü¡¡£¡¡¡£Ü¡¡¡¡¡¡¡¡£Ü¡¡£Ü¡¡¡¡£Ü
£Ü£Ü£Ü¡¡¡¡¡¡¡¡¡¡£Ü¡¡¡¡¡¡£Ü¡¡£Ü
£Ü¡¡£Ü£¡£Ü£ª¡¡£Ü¡¡¡¡¡¡£Ü¡¡£Ü£Ü
£Ü£Ü¡¡¡¡¡¡£Ü¡¡¡¡£Ü¡¡£Ü£Ü£Ü£Ü£Ü
£Ü£Ü£Ü£Ü£Ü£Ü£Ü£Ü£Ü£Ü£Ü£Ü£Ü£Ü£Ü
