£Ü£Ü£Ü£Ü£Ü£Ü£Ü£Ü£Ü£Ü£Ü£Ü£Ü£Ü£Ü
£Ü£Ü£Ü¡¡£Ü¡¡¡¡£Ü¡¡£Ü¡¡£Ü£¡¡¡£Ü
£Ü¡¡£Ü¡¡¡¡¡¡¡¡¡¡£Ü¡¡£¡£Ü£¡¡¡£Ü
£Ü¡¡¡¡¡¡£Ü£Ü¡¡£Ü¡¡¡¡¡¡£Ü¡¡£Ü£Ü
£Ü£Ü¡¡¡¡£Ü¡¡¡¡¡¡£ª¡¡£Ü£Ü¡¡£¡£Ü
£Ü¡¡£Ü¡¡¡¡¡¡¡¡¡¡¡¡¡¡¡¡¡¡£Ü£Ü£Ü
£Ü¡¡£Ü¡¡£Ü£Ü£Ü¡¡¡¡¡¡£Ü£Ü£¡£Ü£Ü
£Ü£Ü£Ü£Ü¡¡¡¡¡¡¡¡¡¡¡¡£¡£Ü¡¡£Ü£Ü
£Ü£Ü£ª¡¡¡¡¡¡¡¡¡¡¡¡¡¡¡¡£Ü£Ü£ª£Ü
£Ü£ª¡¡£Ü£Ü¡¡£Ü£Ü£Ü¡¡¡¡£Ü¡¡¡¡£Ü
£Ü¡¡¡¡£Ü£ª¡¡£Ü£Ü¡¡¡¡¡¡¡¡¡¡¡¡£Ü
£Ü¡¡£Ü£Ü£Ü£À¡¡£Ü£Ü¡¡£Ü£Ü¡¡£¡£Ü
£Ü¡¡£Ü¡¡¡¡¡¡£Ü¡¡¡¡¡¡¡¡£Ü¡¡£Ü£Ü
£Ü¡¡¡¡¡¡¡¡£Ü£Ü¡¡¡¡¡¡¡¡£Ü¡¡£Ü£Ü
£Ü£Ü£Ü£Ü£Ü£Ü£Ü£Ü£Ü£Ü£Ü£Ü£Ü£Ü£Ü
